30 30
******************************
*-----*-------*--------*-----*
*-----*-------*--------*-----*
*-----****----*-----****-----*
*--------*----*-----*--------*
*********#********************
*--------*--*----*--*--------*
*--*******--*----*--*******--*
*--*--------*----*--------*--*
*************----*************
*--*----------------------*--*
*--************************--*
*-----*-------*--------*-----*
*-----*-------*--------*-----*
******************************
*-----*------------*---------*
*-----*------------*---------*
*-----***----------*****-----*
*-------*--------------*-----*
*-------**********************
*--------------*-------------*
*---***--------*-------------*
*-----*--------*-------------*
***************$**-----------*
*-----*----------*-----------*
*-----*----------*************
*-----*----------------------*
*-----*********--------------*
*-----*-------*--------------*
******************************
