29 26
$***********--************
*----*-----*--*-----*----*
*----*-----*--*-----*----*
*----*-----*--*-----*----*
**************************
-----*--*--------*--*----*
-----*--*--------*--*----*
******--****--****--******
-----*-----*--*-----*-----
-----*-----*--*-----*-----
-----*--**********--*-----
-----*--*--------*--*-----
-----*--*--------*--*-----
*********--------*********
-----*--*--------*--*-----
-----*--*--------*--*-----
-----*--**********--*-----
-----*--*--------*--*-----
-----*--*--------*--*-----
************--************
*----*-----*--*-----*----*
*----*-----*--*-----*----*
*----****************----*
*----*--*--------*--*----*
*----*--*--------*--*----*
******--**********--******
*----------*--*----------*
*----------*--*----------*
#*************************
